WWWWWWWWWWWWWWWWWWWWWWWWWWWWWWWWWWWWWWWWWWWWWW
W.........................G................W
W..........................................W
W.....BBBBB..............BBBBB.............W
W.....B...B..............B...B.............W
W.....B.D.B..............B.D.B.............W
W.....B...B..............B...B.............W
W.....BBBBB..............BBBBB.............W
W..........................................W
W..................TTTTT...................W
W..................T...T...................W
W..................T.S.T...................W
W..................T...T...................W
W..................TTTTT...................W
W..........................................W
W.....BBBBB..............BBBBB.............W
W.....B...B..............B...B.............W
W.....B.D.B..............B.D.B.............W
W.....B...B..............B...B.............W
W.....BBBBB..............BBBBB.............W
W..........................................W
W.........................G................W
W..........................................W
WWWWWWWWWWWWWWWWWWWWWWWWWWWWWWWWWWWWWWWWWWWW
