WWWWWWWWWWWW
W..........W
W.D........W
W.....S....W
WWWWWWWWWWWW
