WWWWWWWWWWWWWWWWWWWW
W...WW...W..WW...WWW
W.W....W.W.W...W.W.W
W...W....W.W.W.W...W
W.W.WWWW.W...W.W.W.W
WWWWW......WWWW..W.W
W.W...WWW.W.....W..W
W.WWW..W..WW...W..WW
W...WW.W...WW..WW..W
W.WWW..WW..W..WW.W.W
W.W.....W..W.WW....W
W.WW.W.WWW.W.W..W..W
W..W.W...W.W...WW..W
W......W...W.W...W.W
WWWWWWWWWWWWWWWWWWWW
